"date","total_open_interest","non-comercial_long","non-comercial_short","non-comercial_spreading","comercial_long","comercial_short","total_long","total_short","nonreportable_positions_long","nonreportable_positions_short"
2005-01-04,"683120","74567","67020","74091","479579","465979","628237","607090","54883","76030"
2005-01-11,"707361","79563","70949","90144","488223","478166","657930","639259","49431","68102"
2005-01-18,"718813","86451","70526","85441","495530","491377","667422","647344","51391","71469"
2005-01-25,"713890","98204","64354","90677","476155","494844","665036","649875","48854","64015"
2005-02-01,"734197","100507","69555","96217","492654","507975","689378","673747","44819","60450"
2005-02-08,"731161","99003","71446","96369","481481","490249","676853","658064","54308","73097"
2005-02-15,"740087","101963","70335","104533","480980","493378","687476","668246","52611","71841"
2005-02-22,"760290","120964","66788","100524","484386","524236","705874","691548","54416","68742"
2005-03-01,"775874","130797","70624","97516","482665","533258","710978","701398","64896","74476"
2005-03-08,"816226","158645","81982","109622","476025","546468","744292","738072","71934","78154"
2005-03-15,"841984","168856","101171","119040","490810","544400","778706","764611","63278","77373"
2005-03-22,"845847","166969","97460","117389","501457","551063","785815","765912","60032","79935"
2005-03-29,"839333","164014","90222","118051","493298","546895","775363","755168","63970","84165"
2005-04-05,"859819","173593","84881","125312","488807","566573","787712","776766","72107","83053"
2005-04-12,"836618","154538","94888","136873","478355","533292","769766","765053","66852","71565"
2005-04-19,"822215","125300","92649","119055","517581","539992","761936","751696","60279","70519"
2005-04-26,"810502","121606","95598","125652","508385","520232","755643","741482","54859","69020"
2005-05-03,"810793","107003","98600","134592","511576","502606","753171","735798","57622","74995"
2005-05-10,"831666","103029","102944","140008","520162","504290","763199","747242","68467","84424"
2005-05-17,"791036","87892","90200","140233","510659","489926","738784","720359","52252","70677"
2005-05-24,"762963","80567","94886","121520","507855","479026","709942","695432","53021","67531"
2005-05-31,"783354","83989","101390","133243","512236","473136","729468","707769","53886","75585"
2005-06-07,"783546","92147","90772","133195","496939","485653","722281","709620","61265","73926"
2005-06-14,"807148","99237","86674","119735","529397","522129","748369","728538","58779","78610"
2005-06-21,"771615","108262","88415","109187","496818","500964","714267","698566","57348","73049"
2005-06-28,"783203","112569","90561","122155","481358","487852","716082","700568","67121","82635"
2005-07-05,"813974","121277","88519","128945","493272","510966","743494","728430","70480","85544"
2005-07-12,"828196","122269","88240","132995","502119","527788","757383","749023","70813","79173"
2005-07-19,"822636","108705","89806","137627","511125","523348","757457","750781","65179","71855"
2005-07-26,"802588","106194","94265","138605","502164","504112","746963","736982","55625","65606"
2005-08-02,"840179","121061","94991","160738","490451","508328","772250","764057","67929","76122"
2005-08-09,"887515","139400","104412","162445","509259","533649","811104","800506","76411","87009"
2005-08-16,"957767","154463","114068","181002","552971","578683","888436","873753","69331","84014"
2005-08-23,"896090","140449","124729","167989","522331","530687","830769","823405","65321","72685"
2005-09-06,"897560","140777","116683","161402","524902","540460","827081","818545","70479","79015"
2005-09-13,"872847","114638","122886","144157","534826","526988","793621","794031","79226","78816"
2005-09-20,"846588","110078","123181","142188","532544","511803","784810","777172","61778","69416"
2005-09-27,"851214","107481","133810","146110","541508","502633","795099","782553","56115","68661"
2005-10-04,"866124","118480","145731","157792","529094","490136","805366","793659","60758","72465"
2005-10-11,"852369","106875","147445","142128","545812","485853","794815","775426","57554","76943"
2005-10-18,"860139","123903","150021","133867","549911","503139","807681","787027","52458","73112"
2005-10-25,"817409","120653","158737","123620","523109","464980","767382","747337","50027","70072"
2005-11-01,"821833","120127","162167","126950","521071","461207","768148","750324","53685","71509"
2005-11-08,"830757","122079","169895","128331","530501","465085","780911","763311","49846","67446"
2005-11-15,"845065","115494","171662","121405","543858","473204","780757","766271","64308","78794"
2005-11-22,"805527","115470","158534","117270","527909","466685","760649","742489","44878","63038"
2005-11-29,"836948","121151","164924","125868","541974","476674","788993","767466","47955","69482"
2005-12-06,"861412","131832","161359","123786","540058","496329","795676","781474","65736","79938"
2005-12-13,"869209","132646","162587","128745","540179","497197","801570","788529","67639","80680"
2005-12-20,"813180","120418","137409","115597","524385","494288","760400","747294","52780","65886"
2005-12-27,"818841","120638","144892","117933","534297","488984","772868","751809","45973","67032"
2006-01-03,"849868","131842","146245","128864","532650","503932","793356","779041","56512","70827"
2006-01-10,"892949","145309","146031","143685","535003","531922","823997","821638","68952","71311"
2006-01-17,"909573","148056","149732","144273","550045","547558","842374","841563","67199","68010"
2006-01-24,"908242","151138","145597","148202","548218","554903","847558","848702","60684","59540"
2006-01-31,"951012","157003","137033","148161","577385","602159","882549","887353","68463","63659"
2006-02-07,"941180","137673","138212","152145","581157","586702","870975","877059","70205","64121"
2006-02-14,"926564","129197","147698","151570","580179","566940","860946","866208","65618","60356"
2006-02-21,"889301","112024","142152","141275","582703","549345","836002","832772","53299","56529"
2006-02-28,"941616","120612","146263","147073","609660","574726","877345","868062","64271","73554"
2006-03-07,"966478","125295","144421","146815","629460","604761","901570","895997","64908","70481"
2006-03-14,"980280","130086","145344","159269","626316","607141","915671","911754","64609","68526"
2006-03-21,"928551","128840","135177","153850","591054","568164","873744","857191","54807","71360"
2006-03-28,"936136","135158","127940","168302","575511","572701","878971","868943","57165","67193"
2006-04-04,"967908","149602","119577","190483","571827","583515","911912","893575","55996","74333"
2006-04-11,"987579","157568","129319","191278","575785","598821","924631","919418","62948","68161"
2006-04-18,"1002719","183102","116353","196340","557424","616604","936866","929297","65853","73422"
2006-04-25,"1017674","198211","124188","204796","547166","613121","950173","942105","67501","75569"
2006-05-02,"1091791","216298","122204","241419","566318","654404","1024035","1018027","67756","73764"
2006-05-09,"1090810","200949","114607","241620","572734","655010","1015303","1011237","75507","79573"
2006-05-16,"1068817","199020","120813","251434","549687","623409","1000141","995656","68676","73161"
2006-05-23,"995266","171787","117187","224494","541891","585459","938172","927140","57094","68126"
2006-05-30,"1018291","175621","127164","221523","556137","599026","953281","947713","65010","70578"
2006-06-06,"1044132","179813","135933","224183","575586","612987","979582","973103","64550","71029"
2006-06-13,"1044276","173067","135515","220553","597343","621997","990963","978065","53313","66211"
2006-06-20,"968619","161715","134969","191966","563221","576325","916902","903260","51717","65359"
2006-06-27,"991500","171371","134557","204658","559567","583683","935596","922898","55904","68602"
2006-07-03,"1013523","176166","130888","213571","563193","596678","952930","941137","60593","72386"
2006-07-11,"1061431","193203","135437","226481","578453","625400","998137","987318","63294","74113"
2006-07-18,"1086762","191819","135050","229304","596480","652937","1017603","1017291","69159","69471"
2006-07-25,"1051351","185092","124807","235216","570447","624736","990755","984759","60596","66592"
2006-08-01,"1109838","189224","123129","249726","610969","674562","1049919","1047417","59919","62421"
2006-08-08,"1164949","197612","127082","256860","647964","716391","1102436","1100333","62513","64616"
2006-08-15,"1209950","196301","112507","263204","690208","765049","1149713","1140760","60237","69190"
2006-08-22,"1122955","183323","114408","242319","640982","704973","1066624","1061700","56331","61255"
2006-08-29,"1149670","179681","118820","232942","676822","726335","1089445","1078097","60225","71573"
2006-09-05,"1170266","179017","131700","234136","700190","735683","1113343","1101519","56923","68747"
2006-09-12,"1213940","177047","140027","237407","730801","752627","1145255","1130061","68685","83879"
2006-09-19,"1177409","161535","139037","229361","717492","719409","1108388","1087807","69021","89602"
2006-09-26,"1148838","166460","152775","229433","693367","690611","1089260","1072819","59578","76019"
2006-10-03,"1173630","159235","159104","240079","711235","697748","1110549","1096931","63081","76699"
2006-10-10,"1193421","159359","159058","249544","720323","702636","1129226","1111238","64195","82183"
2006-10-17,"1186170","152971","155667","238527","726932","709889","1118430","1104083","67740","82087"
2006-10-24,"1133789","159629","164654","214026","694661","677504","1068316","1056184","65473","77605"
2006-10-31,"1158612","162794","174105","224318","693010","674656","1080122","1073079","78490","85533"
2006-11-07,"1160833","171129","175923","220872","698770","685537","1090771","1082332","70062","78501"
2006-11-14,"1220474","165257","147904","250258","742030","741315","1157545","1139477","62929","80997"
2006-11-21,"1152869","164956","152519","231193","690924","701626","1087073","1085338","65796","67531"
2006-11-28,"1172455","169872","158058","240975","700084","702698","1110931","1101731","61524","70724"
2006-12-05,"1218680","167778","148767","264976","719307","717578","1152061","1131321","66619","87359"
2006-12-12,"1222508","167097","154639","252053","729439","736196","1148589","1142888","73919","79620"
2006-12-19,"1161945","157670","138823","230358","713041","714703","1101069","1083884","60876","78061"
2006-12-26,"1179893","160309","140461","230586","724075","727830","1114970","1098877","64923","81016"
2007-01-03,"1226641","167725","165531","236762","754040","744275","1158527","1146568","68114","80073"
2007-01-09,"1280292","164334","186692","252168","787948","763322","1204450","1202182","75842","78110"
2007-01-16,"1317380","176223","178255","265867","799360","797050","1241450","1241172","75930","76208"
2007-01-23,"1269598","171292","179791","239696","783782","774631","1194770","1194118","74828","75480"
2007-01-30,"1306996","166578","180920","244747","818277","798053","1229602","1223720","77394","83276"
2007-02-06,"1298456","152746","174070","259980","822984","784268","1235710","1218318","62746","80138"
2007-02-13,"1322794","172152","179365","243777","846255","824808","1262184","1247950","60610","74844"
2007-02-20,"1227487","168334","160472","208557","791297","783167","1168188","1152196","59299","75291"
2007-02-27,"1269208","178043","152004","212742","809294","819492","1200079","1184238","69129","84970"
2007-03-06,"1275194","172082","135759","229938","813652","833204","1215672","1198901","59522","76293"
2007-03-13,"1322242","172387","135273","236274","841942","863258","1250603","1234805","71639","87437"
2007-03-20,"1312508","170982","126616","223708","851705","883689","1246395","1234013","66113","78495"
2007-03-27,"1330479","179645","139466","226699","857149","884128","1263493","1250293","66986","80186"
2007-04-03,"1358053","196329","129654","229386","865686","922271","1291401","1281311","66652","76742"
2007-04-10,"1326403","202367","127183","240837","805157","877168","1248361","1245188","78042","81215"
2007-04-17,"1309533","206586","125771","241827","787440","863540","1235853","1231138","73680","78395"
2007-04-24,"1316177","199503","135674","240073","802849","863657","1242425","1239404","73752","76773"
2007-05-01,"1341807","195239","129116","245093","830557","890444","1270889","1264653","70918","77154"
2007-05-08,"1384509","188498","132500","247040","878277","928131","1313815","1307671","70694","76838"
2007-05-15,"1448897","192274","147702","254385","922957","937291","1369616","1339378","79281","109519"
2007-05-22,"1350183","175892","122431","251029","854885","899264","1281806","1272724","68377","77459"
2007-05-29,"1388590","180467","145223","260023","878166","910866","1318656","1316112","69934","72478"
2007-06-05,"1423761","180566","125651","264951","897214","947336","1342731","1337938","81030","85823"
2007-06-12,"1432636","184720","120249","281110","894844","942743","1360674","1344102","71962","88534"
2007-06-19,"1422817","200772","133351","256860","885045","951249","1342677","1341460","80140","81357"
2007-06-26,"1436152","197493","130329","274980","876792","949216","1349265","1354525","86887","81627"
2007-07-03,"1499897","228644","131271","292254","902584","997112","1423482","1420637","76415","79260"
2007-07-10,"1546372","250071","136758","301904","917338","1030407","1469313","1469069","77059","77303"
2007-07-17,"1549425","248968","137421","313839","906067","1012454","1468874","1463714","80551","85711"
2007-07-24,"1485746","255068","144162","281114","876777","990712","1412959","1415988","72787","69758"
2007-07-31,"1521237","266519","136904","283275","895645","1017457","1445439","1437636","75798","83601"
2007-08-07,"1504817","233568","124646","292328","893870","1014069","1419766","1431043","85051","73774"
2007-08-14,"1516963","220585","154478","427396","789913","860484","1437894","1442358","79069","74605"
2007-08-21,"1422175","206977","184170","369981","779594","804306","1356552","1358457","65623","63718"
2007-08-28,"1432723","202843","195413","378938","782357","789516","1364138","1363867","68585","68856"
2007-09-04,"1489231","221536","188679","402861","796540","812988","1420937","1404528","68294","84703"
2007-09-11,"1544715","231243","204634","432340","804758","822797","1468341","1459771","76374","84944"
2007-09-18,"1488381","238336","199267","392511","777413","806861","1408260","1398639","80121","89742"
2007-09-25,"1409620","243458","215377","377095","716674","746503","1337227","1338975","72393","70645"
2007-10-02,"1426044","239250","197788","388492","719520","764046","1347262","1350326","78782","75718"
2007-10-09,"1440924","247233","193863","391295","722288","772262","1360816","1357420","80108","83504"
2007-10-16,"1489293","251001","182401","397416","756424","814867","1404841","1394684","84452","94609"
2007-10-23,"1408072","243931","201489","382925","708107","750224","1334963","1334638","73109","73434"
2007-10-30,"1448114","246342","180630","390324","727223","787214","1363889","1358168","84225","89946"
2007-11-06,"1513362","251944","163343","429587","765466","832439","1446997","1425369","66365","87993"
2007-11-13,"1445162","225232","214410","370642","774613","781005","1370487","1366057","74675","79105"
2007-11-20,"1397984","236026","201460","349978","746107","759417","1332111","1310855","65873","87129"
2007-11-27,"1404428","230982","186421","356769","748921","788382","1336672","1331572","67756","72856"
2007-12-04,"1382526","215237","181083","355973","737563","769928","1308773","1306984","73753","75542"
2007-12-11,"1380907","214193","176167","360513","732035","761245","1306741","1297925","74166","82982"
2007-12-18,"1330250","213103","184050","333249","714368","737563","1260720","1254862","69530","75388"
2007-12-24,"1325751","219382","171020","333504","700750","746970","1253636","1251494","72115","74257"
2007-12-31,"1361258","238970","151315","356127","689341","775037","1284438","1282479","76820","78779"
2008-01-08,"1413956","244299","147208","380740","702120","804794","1327159","1332742","86797","81214"
2008-01-15,"1458072","232774","143916","394887","735031","830952","1362692","1369755","95380","88317"
2008-01-22,"1343167","200595","168208","358899","708730","742425","1268224","1269532","74943","73635"
2008-01-29,"1365807","211680","190335","357439","727239","749814","1296358","1297588","69449","68219"
2008-02-05,"1368524","205649","184815","357506","731825","750186","1294980","1292507","73544","76017"
2008-02-12,"1393035","217510","185936","352138","717080","745614","1286728","1283688","106307","109347"
2008-02-19,"1355135","232424","177226","335437","704558","753061","1272419","1265724","82716","89411"
2008-02-26,"1405922","257989","172319","350594","709189","788987","1317772","1311900","88150","94022"
2008-03-04,"1450956","261451","159390","386270","717686","823043","1365407","1368703","85549","82253"
2008-03-11,"1484417","260590","145445","408101","740892","839961","1409583","1393507","74834","90910"
2008-03-18,"1407359","248557","165435","360806","726265","793243","1335628","1319484","71731","87875"
2008-03-25,"1362667","226381","181418","367543","700979","744207","1294903","1293168","67764","69499"
2008-04-01,"1381645","225434","187730","385500","705007","735800","1315941","1309030","65704","72615"
2008-04-08,"1412326","238320","181152","400400","702375","744416","1341095","1325968","71231","86358"
2008-04-15,"1441373","247474","183942","401834","722404","767014","1371712","1352790","69661","88583"
2008-04-22,"1337055","249283","169430","358379","664898","714650","1272560","1242459","64495","94596"
2008-04-29,"1365456","258388","188091","365696","665205","719520","1289289","1273307","76167","92149"
2008-05-06,"1422431","266733","194690","386270","685343","718277","1338346","1299237","84085","123194"
2008-05-13,"1477007","267721","191611","397468","730973","774688","1396162","1363767","80845","113240"
2008-05-20,"1356657","247469","193318","360900","665701","689065","1274070","1243283","82587","113374"
2008-05-27,"1338874","229157","190132","359021","667020","691347","1255198","1240500","83676","98374"
2008-06-03,"1355667","218962","188092","386831","681448","703698","1287241","1278621","68426","77046"
2008-06-10,"1418749","218484","196207","394200","734166","745132","1346850","1335539","71899","83210"
2008-06-17,"1335207","203806","198081","358009","686667","677778","1248482","1233868","86725","101339"
2008-06-24,"1306075","211137","190540","362591","661176","652921","1234904","1206052","71171","100023"
2008-07-01,"1294480","221478","194966","350730","641480","664448","1213688","1210144","80792","84336"
2008-07-08,"1316278","216841","202695","360267","672082","679465","1249190","1242427","67088","73851"
2008-07-15,"1344411","210013","187631","369766","670135","686747","1249914","1244144","94497","100267"
2008-07-22,"1217375","198019","201659","322639","641265","626528","1161923","1150826","55452","66549"
2008-07-29,"1220537","201622","202282","328020","629322","616483","1158964","1146785","61573","73752"
2008-08-05,"1249302","197332","202882","349819","644820","629928","1191971","1182629","57331","66673"
2008-08-12,"1241415","192081","201211","354371","639599","620621","1186051","1176203","55364","65212"
2008-08-19,"1203758","204335","192676","313490","623370","625635","1141195","1131801","62563","71957"
2008-08-26,"1187623","205459","185293","323377","600916","612306","1129752","1120976","57871","66647"
2008-09-02,"1226876","193540","179209","344655","609817","612323","1148012","1136187","78864","90689"
2008-09-09,"1231450","198328","191992","343465","616150","613628","1157943","1149085","73507","82365"
2008-09-16,"1241629","202219","182840","361813","618286","638509","1182318","1183162","59311","58467"
2008-09-23,"1113388","204940","163212","297618","553627","580678","1056185","1041508","57203","71880"
2008-09-30,"1092411","192759","152666","298096","553752","576164","1044607","1026926","47804","65485"
2008-10-07,"1087569","165772","162082","292938","582858","569694","1041568","1024714","46001","62855"
2008-10-14,"1090251","164118","166017","286746","587458","569899","1038322","1022662","51929","67589"
2008-10-21,"1035697","174773","174290","243950","573958","563736","992681","981976","43016","53721"
2008-10-28,"1073159","185108","193514","262625","582536","559399","1030269","1015538","42890","57621"
2008-11-04,"1125366","191433","201976","301771","589839","555550","1083043","1059297","42323","66069"
2008-11-11,"1154740","192267","245251","292660","615996","568518","1100923","1106429","53817","48311"
2008-11-18,"1122604","184453","173468","300339","573044","576098","1057836","1049905","64768","72699"
2008-11-25,"1120731","179329","176539","290891","591490","594492","1061710","1061922","59021","58809"
2008-12-02,"1147475","180960","178711","302274","598755","596533","1081989","1077518","65486","69957"
2008-12-09,"1168030","192419","181612","313139","584622","597611","1090180","1092362","77850","75668"
2008-12-16,"1166910","205840","141720","310982","566896","627663","1083718","1080365","83192","86545"
2008-12-22,"1135539","215665","143095","307814","550623","621312","1074102","1072221","61437","63318"
2008-12-30,"1169215","224746","160198","308061","571955","636786","1104762","1105045","64453","64170"
2009-01-06,"1215189","235246","158588","310030","588650","655186","1133926","1123804","81263","91385"
2009-01-13,"1246827","228912","175618","311369","621835","674340","1162116","1161327","84711","85500"
2009-01-20,"1250327","225424","179290","304031","633949","672365","1163404","1155686","86923","94641"
2009-01-27,"1245999","226101","174449","300179","635238","676012","1161518","1150640","84481","95359"
2009-02-03,"1254242","234724","205448","302181","638532","665187","1175437","1172816","78805","81426"
2009-02-10,"1237590","239563","222985","303667","623432","640457","1166662","1167109","70928","70481"
2009-02-17,"1230255","243728","198712","288538","629554","665245","1161820","1152495","68435","77760"
2009-02-24,"1179171","234105","205356","285077","588487","619031","1107669","1109464","71502","69707"
2009-03-03,"1191724","214302","214834","287242","613910","610109","1115454","1112185","76270","79539"
2009-03-10,"1210253","197055","203070","297822","641564","648468","1136441","1149360","73812","60893"
2009-03-17,"1197113","195950","182443","268585","660645","677035","1125180","1128063","71933","69050"
2009-03-24,"1160240","192871","175234","263814","639673","662394","1096358","1101442","63882","58798"
2009-03-31,"1148687","184850","178304","245520","647102","658553","1077472","1082377","71215","66310"
2009-04-07,"1162312","186928","174435","259443","650424","669668","1096795","1103546","65517","58766"
2009-04-14,"1192619","180982","176020","264260","671472","685580","1116714","1125860","75905","66759"
2009-04-21,"1140230","180383","194988","248511","635931","633346","1064825","1076845","75405","63385"
2009-04-28,"1139336","174308","174000","241094","650007","642918","1065409","1058012","73927","81324"
2009-05-05,"1197954","175443","186728","262131","667069","662705","1104643","1111564","93311","86390"
2009-05-12,"1246806","170991","167925","277306","673149","690277","1121446","1135508","125360","111298"
2009-05-19,"1093976","175047","139810","257340","578870","626843","1011257","1023993","82719","69983"
2009-05-26,"1095865","185237","145115","258216","569025","624670","1012478","1028001","83387","67864"
2009-06-02,"1191638","199497","159810","279557","597601","654322","1076655","1093689","114983","97949"
2009-06-09,"1203679","204490","156607","288748","589809","656131","1083047","1101486","120632","102193"
2009-06-16,"1198182","201362","174932","279561","614337","660678","1095260","1115171","102922","83011"
2009-06-23,"1110597","201463","162093","255513","572646","624003","1029622","1041609","80975","68988"
2009-06-30,"1159868","210249","169472","271131","576502","629933","1057882","1070536","101986","89332"
2009-07-07,"1162597","193867","178510","264799","620812","648692","1079478","1092001","83119","70596"
2009-07-14,"1203729","194213","178056","264411","641755","670225","1100379","1112692","103350","91037"
2009-07-21,"1149799","191829","189611","252638","633889","645398","1078356","1087647","71443","62152"
2009-07-28,"1173580","199654","195078","255363","640468","654676","1095485","1105117","78095","68463"
2009-08-04,"1202598","219556","185411","273584","621573","668316","1114713","1127311","87885","75287"
2009-08-11,"1172385","214274","187197","279466","594530","634308","1088270","1100971","84115","71414"
2009-08-18,"1173172","208367","185669","274894","614569","636515","1097830","1097078","75342","76094"
2009-08-25,"1159096","225204","185672","267721","588462","634771","1081387","1088164","77709","70932"
2009-09-01,"1164511","215729","187135","267723","607591","645206","1091043","1100064","73468","64447"
2009-09-08,"1178263","211936","178824","260391","629710","667430","1102037","1106645","76226","71618"
2009-09-15,"1197629","219352","173795","273646","629344","676051","1122342","1123492","75287","74137"
2009-09-22,"1124865","231093","168877","240075","579274","649080","1050442","1058032","74423","66833"
2009-09-29,"1178475","231180","189038","269415","601709","651778","1102304","1110231","76171","68244"
2009-10-06,"1248517","235569","185563","278865","631663","675950","1146097","1140378","102420","108139"
2009-10-13,"1263193","252327","183491","301580","601526","664318","1155433","1149389","107760","113804"
2009-10-20,"1216356","275122","200739","270377","568480","647639","1113979","1118755","102377","97601"
2009-10-27,"1220540","285475","175856","276270","573391","672134","1135136","1124260","85404","96280"
2009-11-03,"1191055","277025","173208","262921","578797","694916","1118743","1131045","72312","60010"
2009-11-09,"1234952","269879","181834","252640","608136","719207","1130655","1153681","104297","81271"
2009-11-17,"1250074","250170","163822","249372","609511","722123","1109053","1135317","141021","114757"
2009-11-24,"1182804","237667","162174","254117","602507","707843","1094291","1124134","88513","58670"
2009-12-01,"1209796","238536","162143","270151","605606","701729","1114293","1134023","95503","75773"
2009-12-08,"1217908","237538","169721","270965","613740","700945","1122243","1141631","95665","76277"
2009-12-15,"1217100","239601","186409","261918","627885","699857","1129404","1148184","87696","68916"
2009-12-22,"1159436","235768","160506","240270","612836","696962","1088874","1097738","70562","61698"
2009-12-29,"1185208","247499","153421","250490","612391","718686","1110380","1122597","74828","62611"
2010-01-05,"1231436","265034","156199","269160","611986","738471","1146180","1163830","85256","67606"
2010-01-12,"1300867","291426","155757","313944","613653","764289","1219023","1233990","81844","66877"
2010-01-19,"1324903","280410","146029","322275","643780","796774","1246465","1265078","78438","59825"
2010-01-26,"1320661","246573","146953","327078","661990","784287","1235641","1258318","85020","62343"
2010-02-02,"1360697","242085","156058","347076","676881","772175","1266042","1275309","94655","85388"
2010-02-09,"1307602","225068","183008","320352","686710","734745","1232130","1238105","75472","69497"
2010-02-16,"1301624","236003","167567","312978","685344","752309","1234325","1232854","67299","68770"
2010-02-23,"1280235","247723","162371","300021","648842","741710","1196586","1204102","83649","76133"
2010-03-02,"1297435","255659","164242","299105","662655","765415","1217419","1228762","80016","68673"
2010-03-09,"1348241","269578","160264","307014","677369","801399","1253961","1268677","94280","79564"
2010-03-16,"1357426","283006","158863","307932","684361","820497","1275299","1287292","82127","70134"
2010-03-23,"1298539","271681","159762","304457","643285","769601","1219423","1233820","79116","64719"
2010-03-30,"1283846","279945","162791","299800","623402","756634","1203147","1219225","80699","64621"
2010-04-06,"1343407","306682","178544","324262","619811","765826","1250755","1268632","92652","74775"
2010-04-13,"1392323","295296","181932","323864","674074","820101","1293234","1325897","99089","66426"
2010-04-20,"1356869","283157","161682","309441","674768","822894","1267366","1294017","89503","62852"
2010-04-27,"1395964","274234","164970","329189","696095","834264","1299518","1328423","96446","67541"
2010-05-04,"1445326","281495","171625","340511","713307","844153","1335313","1356289","110013","89037"
2010-05-11,"1470234","285507","192612","344534","731149","849828","1361190","1386974","109044","83260"
2010-05-18,"1387907","279604","212243","316237","696071","782700","1291912","1311180","95995","76727"
2010-05-25,"1345993","260710","220267","305376","697932","751022","1264018","1276665","81975","69328"
2010-06-01,"1367020","259155","234280","325785","698888","728522","1283828","1288587","83192","78433"
2010-06-08,"1322308","255375","237918","333916","659634","682691","1248925","1254525","73383","67783"
2010-06-15,"1336533","248883","215953","335522","676780","704718","1261185","1256193","75348","80340"
2010-06-22,"1260132","238384","198749","308137","643482","684721","1190003","1191607","70129","68525"
2010-06-29,"1259675","238756","201636","309985","632918","674062","1181659","1185683","78016","73992"
2010-07-06,"1271853","238709","212494","323292","625701","660770","1187702","1196556","84151","75297"
2010-07-13,"1276328","239531","204886","310664","654988","683030","1205183","1198580","71145","77748"
2010-07-20,"1214183","231747","195602","290459","627668","656415","1149874","1142476","64309","71707"
2010-07-27,"1240029","235739","191426","306665","623135","666022","1165539","1164113","74490","75916"
2010-08-03,"1234649","254919","199241","295726","607248","658628","1157893","1153595","76756","81054"
2010-08-10,"1274605","254542","194206","322096","619187","683822","1195825","1200124","78780","74481"
2010-08-17,"1267340","257563","195507","303241","623658","697504","1184462","1196252","82878","71088"
2010-08-24,"1246784","260005","232682","297275","603247","652375","1160527","1182332","86257","64452"
2010-08-31,"1308042","274240","261120","311510","636344","662522","1222094","1235152","85948","72890"
2010-09-07,"1347231","270563","260074","304670","690944","716383","1266177","1281127","81054","66104"
2010-09-14,"1336392","286962","238625","294705","676774","729611","1258441","1262941","77951","73451"
2010-09-21,"1324114","287028","243128","328952","627365","687037","1243345","1259117","80769","64997"
2010-09-28,"1332755","293470","231974","322084","635045","707401","1250599","1261459","82156","71296"
2010-10-05,"1407933","319363","203337","366657","639534","762465","1325554","1332459","82379","75474"
2010-10-12,"1442044","324993","195667","374624","656827","800064","1356444","1370355","85600","71689"
2010-10-19,"1422821","310303","209473","353996","672616","790891","1336915","1354360","85906","68461"
2010-10-26,"1394673","323154","197883","344471","643649","778607","1311274","1320961","83399","73712"
2010-11-02,"1433324","336668","206560","361860","649345","793908","1347873","1362328","85451","70996"
2010-11-09,"1486195","347488","203381","381908","663719","830300","1393115","1415589","93080","70606"
2010-11-16,"1399774","330487","158496","348191","621489","820432","1300167","1327119","99607","72655"
2010-11-23,"1331203","317663","176217","328275","598938","764560","1244876","1269052","86327","62151"
2010-11-30,"1342325","311396","164502","336169","605970","778565","1253535","1279236","88790","63089"
2010-12-07,"1367119","340709","164152","323296","610602","811086","1274607","1298534","92512","68585"
2010-12-14,"1380779","329113","166328","319520","641482","833165","1290115","1319013","90664","61766"
2010-12-21,"1369544","321441","161027","301255","663325","854606","1286021","1316888","83523","52656"
2010-12-28,"1401989","333184","170634","305051","676627","875238","1314862","1350923","87127","51066"
2011-01-04,"1471226","331128","181662","359689","689454","877677","1380271","1419028","90955","52198"
2011-01-11,"1501588","337239","168154","364930","709218","912859","1411387","1445943","90201","55645"
2011-01-18,"1491996","326830","160279","353968","714813","924316","1395611","1438563","96385","53433"
2011-01-25,"1499599","305004","161687","362227","732472","919226","1399703","1443140","99896","56459"
2011-02-01,"1531942","324925","172216","369595","737246","934026","1431766","1475837","100176","56105"
2011-02-08,"1536606","323090","157582","371784","731996","953006","1426870","1482372","109736","54234"
2011-02-15,"1559669","321167","155653","396471","730682","947238","1448320","1499362","111349","60307"
2011-02-22,"1506594","350580","131558","370447","686406","945303","1407433","1447308","99161","59286"
2011-03-01,"1569519","399042","127155","389817","671182","990851","1460041","1507823","109478","61696"
2011-03-08,"1572544","409817","134235","383456","675232","992296","1468505","1509987","104039","62557"
2011-03-15,"1580632","394890","140322","398160","674319","984522","1467369","1523004","113263","57628"
2011-03-22,"1503614","382740","129012","358070","655997","959977","1396807","1447059","106807","56555"
2011-03-29,"1516081","392867","137973","365686","655387","952880","1413940","1456539","102141","59542"
2011-04-05,"1566762","394454","142303","397359","667562","956583","1459375","1496245","107387","70517"
2011-04-12,"1584517","385641","142380","414256","666455","953925","1466352","1510561","118165","73956"
2011-04-19,"1539895","405826","151795","367737","666080","961244","1439643","1480776","100252","59119"
2011-04-26,"1553704","404938","146870","373727","676873","968323","1455538","1488920","98166","64784"
2011-05-03,"1624328","399341","155015","410705","713611","997315","1523657","1563035","100671","61293"
2011-05-10,"1653799","380615","169101","434232","746443","989614","1561290","1592947","92509","60852"
2011-05-17,"1582868","344633","141554","413835","723749","955276","1482217","1510665","100651","72203"
2011-05-24,"1522076","342552","143360","392988","701807","927447","1437347","1463795","84729","58281"
2011-05-31,"1508418","337326","146189","400330","680527","900146","1418183","1446665","90235","61753"
2011-06-07,"1515910","335195","159071","393692","689225","896804","1418112","1449567","97798","66343"
2011-06-14,"1584927","337048","170677","442526","713293","911268","1492867","1524471","92060","60456"
2011-06-21,"1528927","324165","175098","405316","713723","891701","1443204","1472115","85723","56812"
2011-06-28,"1524313","317951","183397","400121","723654","880073","1441726","1463591","82587","60722"
2011-07-05,"1522391","317825","179435","392249","730459","887258","1440533","1458942","81858","63449"
2011-07-12,"1538256","324437","173542","401389","727913","899726","1453739","1474657","84517","63599"
2011-07-19,"1493882","325849","170902","372318","713077","898180","1411244","1441400","82638","52482"
2011-07-26,"1506662","333079","174312","378412","710340","901893","1421831","1454617","84831","52045"
2011-08-02,"1528978","329837","182461","398882","709772","891003","1438491","1472346","90487","56632"
2011-08-09,"1564480","325259","189541","426522","717466","882939","1469247","1499002","95233","65478"
2011-08-16,"1553021","323171","191937","413324","741831","883516","1478326","1488777","74695","64244"
2011-08-23,"1465256","316226","179886","364062","709810","860266","1390098","1404214","75158","61042"
2011-08-30,"1494803","318524","165836","378975","720448","882222","1417947","1427033","76856","67770"
2011-09-06,"1523907","337970","172828","387491","726687","901488","1452148","1461807","71759","62100"
2011-09-13,"1462207","335221","169826","339033","714757","883773","1389011","1392632","73196","69575"
2011-09-20,"1365197","327050","167085","310137","663203","829603","1300390","1306825","64807","58372"
2011-09-27,"1380562","320203","182517","332231","663241","802292","1315675","1317040","64887","63522"
2011-10-04,"1431783","315593","207429","354903","693235","807620","1363731","1369952","68052","61831"
2011-10-11,"1424634","312293","191232","371294","674231","794796","1357818","1357322","66816","67312"
2011-10-18,"1431563","323224","178853","365369","684996","817265","1373589","1361487","57974","70076"
2011-10-25,"1388897","335212","175494","345231","645467","802858","1325910","1323583","62987","65314"
2011-11-01,"1345024","323638","162026","321463","630398","796677","1275499","1280166","69525","64858"
2011-11-08,"1366205","329388","162346","323271","627784","800292","1280443","1285909","85762","80296"
2011-11-15,"1357125","321118","147711","339357","616503","794522","1276978","1281590","80147","75535"
2011-11-22,"1295618","313952","156606","329069","573814","751277","1216835","1236952","78783","58666"
2011-11-29,"1302512","308005","151526","336064","576726","754556","1220795","1242146","81717","60366"
2011-12-06,"1332544","308190","152386","365043","573061","756902","1246294","1274331","86250","58213"
2011-12-13,"1346495","312304","163001","366862","575481","751569","1254647","1281432","91848","65063"
2011-12-20,"1298500","289295","151253","350753","582535","738663","1222583","1240669","75917","57831"
2011-12-27,"1325562","297001","152413","367854","582171","745540","1247026","1265807","78536","59755"
2012-01-03,"1373018","301080","156612","403887","581401","753553","1286368","1314052","86650","58966"
2012-01-10,"1388799","312172","152824","403015","578874","774269","1294061","1330108","94738","58691"
2012-01-17,"1381041","322996","151770","388027","577610","780726","1288633","1320523","92408","60518"
2012-01-24,"1341810","322355","144510","382935","549636","754903","1254926","1282348","86884","59462"
2012-01-31,"1399874","321176","150477","421012","571809","773269","1313997","1344758","85877","55116"
2012-02-07,"1484546","315171","146286","456929","620629","821786","1392729","1425001","91817","59545"
2012-02-14,"1486350","349281","144529","450380","599669","831482","1399330","1426391","87020","59959"
2012-02-21,"1441526","367380","139200","439787","542767","804445","1349934","1383432","91592","58094"
2012-02-28,"1517833","394656","140097","445692","580262","871812","1420610","1457601","97223","60232"
2012-03-06,"1584849","396749","159797","475269","615643","889263","1487661","1524329","97188","60520"
2012-03-13,"1579060","408952","165778","465557","606023","884640","1480532","1515975","98528","63085"
2012-03-20,"1558284","394918","160326","459794","606909","876458","1461621","1496578","96663","61706"
2012-03-27,"1562147","387687","158235","464723","613378","877327","1465788","1500285","96359","61862"
2012-04-03,"1569070","375854","160297","459923","635507","880889","1471284","1501109","97786","67961"
2012-04-10,"1563132","366612","169030","464799","636467","861585","1467878","1495414","95254","67718"
2012-04-17,"1570513","365343","151788","478480","641557","873178","1485380","1503446","85133","67067"
2012-04-24,"1539257","356816","144430","482243","616873","849355","1455932","1476028","83325","63229"
2012-05-01,"1602007","374537","147894","509344","625789","877252","1509670","1534490","92337","67517"
2012-05-08,"1590926","356626","172666","497347","651460","855481","1505433","1525494","85493","65432"
2012-05-15,"1539151","356311","171848","457839","638344","837526","1452494","1467213","86657","71938"
2012-05-22,"1442523","343701","159630","418225","607894","797331","1369820","1375186","72703","67337"
2012-05-29,"1440107","343240","164355","419140","606523","789940","1368903","1373435","71204","66672"
2012-06-05,"1456604","326346","179509","428216","621295","774957","1375857","1382682","80747","73922"
2012-06-12,"1458395","308626","177768","439327","629659","766949","1377612","1384044","80783","74351"
2012-06-19,"1432126","300776","176868","412677","643928","771762","1357381","1361307","74745","70819"
2012-06-26,"1432162","295571","182738","410508","650111","771985","1356190","1365231","75972","66931"
2012-07-03,"1432999","319921","188338","402152","643391","777352","1365464","1367842","67535","65157"
2012-07-10,"1413415","315407","176835","389904","639783","782283","1345094","1349022","68321","64393"
2012-07-17,"1403473","323621","150842","390875","624854","791030","1339350","1332747","64123","70726"
2012-07-24,"1389039","339805","149112","379459","608497","798362","1327761","1326933","61278","62106"
2012-07-31,"1395758","328048","153651","386457","614941","793315","1329446","1333423","66312","62335"
2012-08-07,"1449617","348715","144216","424680","610863","815075","1384258","1383971","65359","65646"
2012-08-14,"1469908","340551","147169","425976","632977","830593","1399504","1403738","70404","66170"
2012-08-21,"1470157","362472","132057","414676","623839","855547","1400987","1402280","69170","67877"
2012-08-28,"1511314","379630","130368","415362","646826","900005","1441818","1445735","69496","65579"
2012-09-04,"1531823","374147","135555","426796","652677","901929","1453620","1464280","78203","67543"
2012-09-11,"1585806","380849","132184","465508","666128","925816","1512485","1523508","73321","62298"
2012-09-18,"1607540","396187","129036","461898","672515","951128","1530600","1542062","76940","65478"
2012-09-25,"1555863","374662","143365","440454","663843","908574","1478959","1492393","76904","63470"
2012-10-02,"1556877","366395","150515","448318","665573","889358","1480286","1488191","76591","68686"
2012-10-09,"1542886","367337","153739","460237","637207","854229","1464781","1468205","78105","74681"
2012-10-16,"1580619","365184","158712","468598","674070","883453","1507852","1510763","72767","69856"
2012-10-23,"1578997","362498","176117","452222","686962","882205","1501682","1510544","77315","68453"
2012-10-30,"1597501","359653","190078","455607","705841","880690","1521101","1526375","76400","71126"
2012-11-06,"1614897","353453","187609","497687","690262","854155","1541402","1539451","73495","75446"
2012-11-13,"1539663","341346","163579","476739","640932","823546","1459017","1463864","80646","75799"
2012-11-20,"1498820","340750","162871","454511","626563","810541","1421824","1427923","76996","70897"
2012-11-27,"1522133","338845","158811","469175","636461","822220","1444481","1450206","77652","71927"
2012-12-04,"1549067","346065","152232","493578","632606","829299","1472249","1475109","76818","73958"
2012-12-11,"1543454","342234","175895","482836","631085","807334","1456155","1466065","87299","77389"
2012-12-18,"1493851","341629","158718","474155","604025","787977","1419809","1420850","74042","73001"
2012-12-24,"1476652","344880","150173","468079","593186","785491","1406145","1403743","70507","72909"
2012-12-31,"1473345","336952","138874","480783","584809","784502","1402544","1404159","70801","69186"
2013-01-08,"1477695","347860","133082","477557","574621","793007","1400038","1403646","77657","74049"
2013-01-15,"1495149","354130","127379","493237","564730","804346","1412097","1424962","83052","70187"
2013-01-22,"1491867","366484","120381","508149","536150","788559","1410783","1417089","81084","74778"
2013-01-29,"1553636","378904","110915","554259","540734","816465","1473897","1481639","79739","71997"
2013-02-05,"1594844","380063","113259","560324","571240","852228","1511627","1525811","83217","69033"
2013-02-12,"1653440","391902","119027","600888","571616","857279","1564406","1577194","89034","76246"
2013-02-19,"1650211","380355","122437","607471","577086","847034","1564912","1576942","85299","73269"
2013-02-26,"1654089","374809","138711","615128","585293","833573","1575230","1587412","78859","66677"
2013-03-05,"1710526","380407","144667","636249","610227","840541","1626883","1621457","83643","89069"
2013-03-12,"1720024","376467","148272","660803","600968","826255","1638238","1635330","81786","84694"
2013-03-19,"1647391","358086","134365","632225","579870","801723","1570181","1568313","77210","79078"
2013-03-26,"1693684","364846","120239","642466","605459","849358","1612771","1612063","80913","81621"
2013-04-02,"1731930","369816","120966","670488","604305","860779","1644609","1652233","87321","79697"
2013-04-09,"1768185","349203","125805","690488","641239","872511","1680930","1688804","87255","79381"
2013-04-16,"1764368","348044","137341","680142","657442","864094","1685628","1681577","78740","82791"
2013-04-23,"1718878","366860","155285","642802","636281","835468","1645943","1633555","72935","85323"
2013-04-30,"1771193","366605","156664","653496","672928","873352","1693029","1683512","78164","87681"
2013-05-07,"1770442","361677","141051","657013","671362","887913","1690052","1685977","80390","84465"
2013-05-14,"1758686","360341","127751","650412","662748","897183","1673501","1675346","85185","83340"
2013-05-21,"1742051","386105","117161","626101","643047","910857","1655253","1654119","86798","87932"
2013-05-28,"1744717","379881","122742","618540","660254","918821","1658675","1660103","86042","84614"
2013-06-04,"1740663","379736","123902","625253","652751","900169","1657740","1649324","82923","91339"
2013-06-11,"1815904","389767","119936","670678","663235","931101","1723680","1721715","92224","94189"
2013-06-18,"1868964","411697","112962","689453","672143","966572","1773293","1768987","95671","99977"
2013-06-25,"1809371","387757","113283","645066","686619","961205","1719442","1719554","89929","89817"
2013-07-02,"1769805","405049","115454","592465","679935","971725","1677449","1679644","92356","90161"
2013-07-09,"1818204","424926","119534","610179","685510","1001694","1720615","1731407","97589","86797"
2013-07-16,"1880612","443242","113793","634688","702809","1042970","1780739","1791451","99873","89161"
2013-07-23,"1865700","476061","114995","593687","700234","1072649","1769982","1781331","95718","84369"
2013-07-30,"1837823","478424","115483","596661","670771","1042692","1745856","1754836","91967","82987"
2013-08-06,"1879218","478249","120723","604653","700317","1063141","1783219","1788517","95999","90701"
2013-08-13,"1934417","474557","124082","646785","719958","1073769","1841300","1844636","93117","89781"
2013-08-20,"1835367","470147","124770","613518","653883","1010155","1737548","1748443","97819","86924"
2013-08-27,"1855284","471493","126363","620317","660743","1026734","1752553","1773414","102731","81870"
2013-09-03,"1856725","464921","125573","632276","658035","1020417","1755232","1778266","101493","78459"
2013-09-10,"1901643","460222","125397","655987","684577","1039453","1800786","1820837","100857","80806"
2013-09-17,"1926402","448359","121528","666834","710214","1054191","1825407","1842553","100995","83849"
2013-09-24,"1881081","431586","110828","636271","718257","1058400","1786114","1805499","94967","75582"
2013-10-01,"1856649","424081","108643","633250","707802","1041475","1765133","1783368","91516","73281"
2013-10-08,"1871940","427951","112357","658085","695078","1026195","1781114","1796637","90826","75303"
2013-10-15,"1824929","416914","113982","641216","680942","998327","1739072","1753525","85857","71404"
2013-10-22,"1785295","425724","126528","612063","666611","983338","1704398","1721929","80897","63366"
2013-10-29,"1774386","422864","120648","570465","707570","1014052","1700899","1705165","73487","69221"
2013-11-05,"1736874","436733","137219","560446","659906","971150","1657085","1668815","79789","68059"
2013-11-12,"1735933","454010","148444","551482","649309","959227","1654801","1659153","81132","76780"
2013-11-19,"1620641","431042","117882","502349","608850","924539","1542241","1544770","78400","75871"
2013-11-26,"1636454","439091","131552","517266","599534","909832","1555891","1558650","80563","77804"
2013-12-03,"1645686","457545","136697","518746","588764","913508","1565055","1568951","80631","76735"
2013-12-10,"1661416","460410","111407","550019","571251","920974","1581680","1582400","79736","79016"
2013-12-17,"1629694","456968","110268","521719","572411","922386","1551098","1554373","78596","75321"
2013-12-24,"1598935","458206","105441","497046","560983","925531","1516235","1528018","82700","70917"
2013-12-31,"1615844","462028","106739","511320","557217","927085","1530565","1545144","85279","70700"
2014-01-07,"1619796","454829","123818","506045","571328","916651","1532202","1546514","87594","73282"
2014-01-14,"1623027","463186","135835","512159","560092","897400","1535437","1545394","87590","77633"
2014-01-21,"1613293","473506","133457","501756","558910","898363","1534172","1533576","79121","79717"
2014-01-28,"1591971","471470","120324","494431","541757","895719","1507658","1510474","84313","81497"
2014-02-04,"1561179","471978","111761","483169","522777","886824","1477924","1481754","83255","79425"
2014-02-11,"1646415","486742","104408","533602","533806","923570","1554150","1561580","92265","84835"
2014-02-18,"1650294","512044","95603","521373","518891","942843","1552308","1559819","97986","90475"
2014-02-25,"1643886","514502","98064","517952","508679","941900","1541133","1557916","102753","85970"
2014-03-04,"1687807","521727","95909","541777","523812","969607","1587316","1607293","100491","80514"
2014-03-11,"1697240","511076","104244","537412","544030","974801","1592518","1616457","104722","80783"
2014-03-18,"1623266","492620","108335","486148","549137","951136","1527905","1545619","95361","77647"
2014-03-25,"1604566","498080","106906","482281","534991","944681","1515352","1533868","89214","70698"
2014-04-01,"1644507","502389","110606","487611","561769","972062","1551769","1570279","92738","74228"
2014-04-08,"1655472","512035","112248","484493","559083","981623","1555611","1578364","99861","77108"
2014-04-15,"1674276","523490","113939","479877","569608","998745","1572975","1592561","101301","81715"
2014-04-22,"1619737","517023","106898","468224","536742","968841","1521989","1543963","97748","75774"
2014-04-29,"1651521","522018","119691","485148","549699","975264","1556865","1580103","94656","71418"
2014-05-06,"1638412","492901","109808","503068","548848","953775","1544817","1566651","93595","71761"
2014-05-13,"1627403","495080","107341","502296","533186","940551","1530562","1550188","96841","77215"
2014-05-20,"1607523","507592","97384","509598","491241","920424","1508431","1527406","99092","80117"
2014-05-27,"1635600","526135","102999","522517","478111","923603","1526763","1549119","108837","86481"
2014-06-03,"1664043","520556","103971","527345","503713","945287","1551614","1576603","112429","87440"
2014-06-10,"1676336","520876","102865","538556","502563","949345","1561995","1590766","114341","85570"
2014-06-17,"1721703","545061","87905","576009","491334","979110","1612404","1643024","109299","78679"
2014-06-24,"1720856","548016","89047","567133","500890","993470","1616039","1649650","104817","71206"
2014-07-01,"1759554","535712","89872","589773","525102","1006484","1650587","1686129","108967","73425"
2014-07-08,"1742131","514431","89544","592803","529159","991789","1636393","1674136","105738","67995"
2014-07-15,"1721704","489729","90126","580946","555328","982263","1626003","1653335","95701","68369"
2014-07-22,"1642836","467574","96130","563586","515037","919302","1546197","1579018","96639","63818"
2014-07-29,"1628926","470115","105376","563294","499084","901473","1532493","1570143","96433","58783"
2014-08-05,"1587187","450544","103340","535224","507949","888645","1493717","1527209","93470","59978"
2014-08-12,"1583609","433331","109265","563442","497574","851593","1494347","1524300","89262","59309"
2014-08-19,"1542337","429288","105815","560325","472925","824648","1462538","1490788","79799","51549"
2014-08-26,"1550253","424250","106523","573594","476824","817401","1474668","1497518","75585","52735"
2014-09-02,"1559353","421058","118494","584454","473149","797786","1478661","1500734","80692","58619"
2014-09-09,"1553516","426580","126598","568974","481142","799772","1476696","1495344","76820","58172"
2014-09-16,"1528614","434417","137136","546365","474589","784472","1455371","1467973","73243","60641"
2014-09-23,"1480629","423239","127187","521237","463661","777661","1408137","1426085","72492","54544"
2014-09-30,"1485856","426689","130743","519575","463442","777653","1409706","1427971","76150","57885"
2014-10-07,"1503764","435642","141959","503380","478317","792221","1417339","1437560","86425","66204"
2014-10-14,"1537452","441625","162845","510275","502768","796168","1454668","1469288","82784","68164"
2014-10-21,"1459981","430349","150248","469996","489718","776972","1390063","1397216","69918","62765"
2014-10-28,"1476289","428086","160782","467950","506560","784767","1402596","1413499","73693","62790"
2014-11-04,"1498736","435649","167117","483032","505734","785187","1424415","1435336","74321","63400"
2014-11-11,"1509371","442119","165287","488816","500755","790156","1431690","1444259","77681","65112"
2014-11-18,"1459175","403713","148350","491300","487153","761936","1382166","1401586","77009","57589"
2014-11-29,"1386635","400621","147620","468726","441995","712053","1311342","1328399","75293","58236"
2014-12-06,"1439654","408718","143722","503248","458206","728152","1370172","1375122","69482","64532"
2014-12-09,"1445093","413755","151979","494424","464774","732606","1372953","1379009","72140","66084"
2014-12-16,"1475862","435032","150953","506012","453797","752236","1394841","1409201","81021","66661"
2014-12-23,"1428829","412781","131132","472925","474099","763506","1359805","1367563","69024","61266"
2014-12-30,"1457729","421184","148700","478383","483055","763632","1382622","1390715","75107","67014"
2015-01-06,"1505101","440821","172021","491015","490464","770342","1422300","1433378","82801","71723"
2015-01-13,"1627535","485464","209984","530829","524442","808229","1540735","1549042","86800","78493"
2015-01-20,"1591022","480508","199239","504784","523019","809270","1508311","1513293","82711","77729"
2015-01-27,"1668047","496281","222010","519451","568519","855154","1584251","1596615","83796","71432"
2015-02-03,"1721471","488256","216060","548341","606100","879692","1642697","1644093","78774","77378"
2015-02-10,"1717593","478989","207462","560559","601733","875752","1641281","1643773","76312","73820"
2015-02-17,"1689966","478741","179351","552470","580414","877046","1611625","1608867","78341","81099"
2015-02-24,"1695437","490905","221068","511265","606080","886414","1608250","1618747","87187","76690"
2015-03-03,"1687908","497948","235659","504362","603558","873958","1605868","1613979","82040","73929"
2015-03-10,"1670894","495142","234483","528820","566050","829530","1590012","1592833","80882","78061"
2015-03-17,"1760721","516956","273468","562180","592777","843911","1671913","1679559","88808","81162"
2015-03-24,"1748067","513586","306699","563562","595063","796768","1672211","1667029","75856","81038"
2015-03-31,"1740134","516028","289333","565775","578627","804973","1660430","1660081","79704","80053"
2015-04-07,"1743733","520929","268886","580097","566266","810094","1667292","1659077","76441","84656"
2015-04-14,"1774773","527985","245825","558996","610009","889504","1696990","1694325","77783","80448"
2015-04-21,"1723025","519353","196261","549291","578434","903278","1647078","1648830","75947","74195"
2015-04-28,"1717417","521704","206860","541282","574587","895204","1637573","1643346","79844","74071"
2015-05-05,"1750082","530764","205058","542540","597211","925721","1670515","1673319","79567","76763"
2015-05-12,"1731678","512443","192231","537538","604581","926687","1654562","1656456","77116","75222"
2015-05-19,"1621198","504615","161184","495495","542015","892555","1542125","1549234","79073","71964"
2015-05-26,"1614397","502001","154010","501608","534528","880746","1538137","1536364","76260","78033"
2015-06-02,"1651499","494450","154932","535722","541163","881118","1571335","1571772","80164","79727"
2015-06-09,"1641774","483798","157943","545121","536555","861689","1565474","1564753","76300","77021"
2015-06-16,"1652013","484932","157799","541220","550591","881477","1576743","1580496","75270","71517"
2015-06-23,"1650025","480001","152568","526368","570430","905389","1576799","1584325","73226","65700"
2015-06-30,"1670091","483021","154842","528492","583581","915252","1595094","1598586","74997","71505"
2015-07-07,"1691891","485862","189702","540979","584819","875695","1611660","1606376","80231","85515"
2015-07-14,"1733695","468034","203647","560368","629452","886354","1657854","1650369","75841","83326"
2015-07-21,"1668737","464330","210647","538946","590689","847827","1593965","1597420","74772","71317"
2015-07-28,"1694436","475975","232556","549072","594197","837805","1619244","1619433","75192","75003"
2015-08-04,"1736523","478684","231591","569788","611685","853973","1660157","1655352","76366","81171"
2015-08-11,"1676233","478863","253020","547638","562096","794521","1588597","1595179","87636","81054"
2015-08-18,"1688731","473198","262634","538809","594104","807933","1606111","1609376","82620","79355"
2015-08-25,"1677151","474160","258597","548590","570710","787559","1593460","1594746","83691","82405"
2015-09-01,"1688806","487177","266835","553169","575960","795030","1616306","1615034","72500","73772"
2015-09-08,"1704251","490149","258719","556425","589357","815763","1635931","1630907","68320","73344"
2015-09-15,"1702949","485819","246433","555863","588064","827022","1629746","1629318","73203","73631"
2015-09-22,"1606217","489204","229775","503809","548373","798144","1541386","1531728","64831","74489"
2015-09-29,"1617902","481485","229757","505252","560375","810124","1547112","1545133","70790","72769"
2015-10-06,"1675676","491100","232839","522704","588749","841962","1602553","1597505","73123","78171"
2015-10-13,"1645951","487740","222748","485171","592561","867428","1565472","1575347","80479","70604"
2015-10-20,"1613562","485090","233939","479894","570449","833815","1535433","1547648","78129","65914"
2015-10-27,"1676033","499628","263053","506491","589108","830691","1595227","1600235","80806","75798"
2015-11-03,"1676897","493384","247193","518056","588480","832852","1599920","1598101","76977","78796"
2015-11-10,"1671590","498945","260623","497827","593266","839338","1590038","1597788","81552","73802"
2015-11-17,"1662829","494099","265544","511653","570121","806942","1575873","1584139","86956","78690"
2015-11-24,"1632471","472273","260248","515648","565152","778625","1553073","1554521","79398","77950"
2015-12-01,"1661176","475582","267104","530687","572148","785020","1578417","1582811","82759","78365"
2015-12-08,"1713573","480088","282214","566426","576108","780931","1622622","1629571","90951","84002"
2015-12-15,"1678527","472228","261717","555650","568272","776411","1596150","1593778","82377","84749"
2015-12-22,"1646306","453681","260769","548314","558814","755495","1560809","1564578","85497","81728"
2015-12-29,"1648904","448632","252281","548671","570892","763508","1568195","1564460","80709","84444"
2016-01-05,"1703201","460417","276240","580111","576069","764634","1616597","1620985","86604","82216"
2016-01-12,"1756232","499795","336291","570030","590227","768467","1660052","1674788","96180","81444"
2016-01-19,"1686382","482774","303402","538105","572363","763410","1593242","1604917","93140","81465"
2016-01-26,"1761883","523710","318000","554243","596459","805509","1674412","1677752","87471","84131"
2016-02-02,"1855603","545820","348947","588100","628739","834525","1762659","1771572","92944","84031"
2016-02-09,"1854379","544800","356923","586476","622695","823581","1753971","1766980","100408","87399"
2016-02-16,"1840051","517940","358953","582324","639559","808554","1739823","1749831","100228","90220"
2016-02-23,"1776696","533268","327412","549808","601482","814711","1684558","1691931","92138","84765"
2016-03-01,"1800298","529761","317243","574081","607281","820159","1711123","1711483","89175","88815"
2016-03-08,"1816474","535589","291337","577225","612412","853501","1725226","1722063","91248","94411"
2016-03-15,"1782857","544416","274560","568095","581508","849245","1694019","1691900","88838","90957"
2016-03-22,"1705631","527838","219861","539732","552733","849662","1620303","1609255","85328","96376"
2016-03-29,"1734511","534637","229126","549599","559331","864381","1643567","1643106","90944","91405"
2016-04-05,"1773774","541716","251586","563171","573780","861607","1678667","1676364","95107","97410"
2016-04-12,"1803510","530256","241095","569566","610370","889604","1710192","1700265","93318","103245"
2016-04-19,"1714186","540048","205873","521472","564810","890588","1626330","1617933","87856","96253"
2016-04-26,"1714689","544282","210017","509037","573706","898781","1627025","1617835","87664","96854"
2016-05-03,"1748628","530023","211479","534401","594804","910011","1659228","1655891","89400","92737"
2016-05-10,"1724987","521799","229839","488331","622408","914029","1632538","1632199","92449","92788"
2016-05-17,"1698980","554596","185827","462414","585350","936779","1602360","1585020","96620","113960"
2016-05-24,"1657419","528230","180088","496561","536824","878566","1561615","1555215","95804","102204"
2016-05-31,"1709540","522661","175659","519981","569242","908604","1611884","1604244","97656","105296"
2016-06-07,"1748314","525508","200326","539793","582024","902186","1647325","1642305","100989","106009"
2016-06-14,"1774350","523352","210767","551992","594703","912235","1670047","1674994","104303","99356"
2016-06-21,"1726381","515227","196632","533424","587495","905076","1636146","1635132","90235","91249"
2016-06-28,"1720740","510395","206156","518308","600141","907925","1628844","1632389","91896","88351"
2016-07-05,"1751823","519441","219769","541480","596556","901593","1657477","1662842","94346","88981"
2016-07-12,"1728765","516217","221422","527690","589838","883190","1633745","1632302","95020","96463"
2016-07-19,"1685116","525628","236047","508032","555110","851112","1588770","1595191","96346","89925"
2016-07-26,"1718306","539345","266046","508243","564140","848481","1611728","1622770","106578","95536"
2016-08-02,"1792640","562532","295340","537234","584462","864164","1684228","1696738","108412","95902"
2016-08-09,"1829979","562028","303778","528277","639378","897585","1729683","1729640","100296","100339"
2016-08-16,"1852402","570209","262709","518943","673303","965732","1762455","1747384","89947","105018"
2016-08-23,"1747499","555022","201278","491094","614046","957594","1660162","1649966","87337","97533"
2016-08-30,"1787891","538363","197075","515643","640120","976684","1694126","1689402","93765","98489"
2016-09-06,"1861718","534074","248279","540835","676917","965584","1751826","1754698","109892","107020"
2016-09-13,"1829620","537965","224663","544337","647463","956418","1729765","1725418","99855","104202"
2016-09-20,"1811705","533133","254260","518286","657846","943677","1709265","1716223","102440","95482"
2016-09-27,"1830991","543799","252153","522518","663872","960739","1730189","1735410","100802","95581"
2016-10-04,"1871665","571306","208330","558938","642976","999197","1773220","1766465","98445","105200"
2016-10-11,"1880412","597569","183919","585618","595974","1005305","1779161","1774842","101251","105570"
2016-10-18,"1811281","578530","170535","570414","562360","971099","1711304","1712048","99977","99233"
2016-10-25,"1821737","571822","168236","588360","557093","971594","1717275","1728190","104462","93547"
2016-11-01,"1854612","543096","188697","598070","596233","971242","1737399","1758009","117213","96603"
2016-11-08,"1973656","560814","283275","624244","673039","972607","1858097","1880126","115559","93530"
2016-11-15,"2027539","581416","305090","606946","734484","1012058","1922846","1924094","104693","103445"
2016-11-22,"1995504","560573","284253","620624","711031","992960","1892228","1897837","103276","97667"
2016-11-29,"2020026","551697","263816","644218","714264","1018949","1910179","1926983","109847","93043"
2016-12-06,"2098290","589787","212161","705458","691607","1090968","1986852","2008587","111438","89703"
2016-12-13,"2104703","614780","192013","693516","685227","1133068","1993523","2018597","111180","86106"
2016-12-20,"2029807","603704","167043","696758","631244","1085341","1931706","1949142","98101","80665"
2016-12-27,"2037834","608865","163933","719247","609540","1068910","1937652","1952090","100182","85744"
2017-01-03,"2089324","608117","168043","730967","640178","1106942","1979262","2005952","110062","83372"
2017-01-10,"2114656","604261","170699","725731","671494","1136894","2001486","2033324","113170","81332"
2017-01-17,"2179122","631537","166859","761640","677537","1159908","2070714","2088407","108408","90715"
2017-01-24,"2151809","642401","159878","747391","657946","1155886","2047738","2063155","104071","88654"
2017-01-31,"2181656","656710","164018","739712","677456","1186594","2073878","2090324","107778","91332"
2017-02-07,"2191158","661929","184939","718973","683625","1188108","2064527","2092020","126631","99138"
2017-02-14,"2183943","683254","174798","659857","734170","1260587","2077281","2095242","106662","88701"
2017-02-21,"2103278","712717","156110","626804","659481","1231266","1999002","2014180","104276","89098"
2017-02-28,"2120334","690281","165027","649177","677820","1223836","2017278","2038040","103056","82294"
2017-03-07,"2137532","682176","173651","665360","682956","1218455","2030492","2057466","107040","80066"
2017-03-14,"2240261","687026","253226","665046","775342","1222748","2127414","2141020","112847","99241"
2017-03-21,"2194206","659029","240512","652678","776277","1209714","2087984","2102904","106222","91302"
2017-03-28,"2222462","647981","249901","692174","778335","1188424","2118490","2130499","103972","91963"
2017-04-04,"2213064","649987","241605","711818","748325","1154097","2110130","2107520","102934","105544"
2017-04-11,"2193567","645953","208910","710854","736046","1165444","2092853","2085208","100714","108359"
2017-04-18,"2161434","637850","193967","699285","728324","1173574","2065459","2066826","95975","94608"
2017-04-25,"2188272","618756","206934","727305","738168","1171793","2084229","2106032","104043","82240"
2017-05-02,"2215531","630692","257548","702986","756754","1166614","2090432","2127148","125099","88383"
2017-05-09,"2276413","655196","326445","678535","832830","1172624","2166561","2177604","109852","98809"
2017-05-16,"2337124","646041","317089","717545","863704","1197211","2227290","2231845","109834","105279"
2017-05-23,"2211099","595499","222510","705639","816945","1185496","2118083","2113645","93016","97454"
2017-05-30,"2198081","595577","221822","699844","806439","1184204","2101860","2105870","96221","92211"
2017-06-06,"2228585","624855","242386","705890","794444","1185263","2125189","2133539","103396","95046"
2017-06-13,"2176740","639309","280310","642205","788989","1164994","2070503","2087509","106237","89231"
2017-06-20,"2118015","628548","299784","588412","783406","1143120","2000366","2031316","117649","86699"
2017-06-27,"2143111","638878","311690","581029","812438","1158776","2032345","2051495","110766","91616"
2017-07-03,"2172632","633802","292755","590740","845140","1183286","2069682","2066781","102950","105851"
2017-07-11,"2133575","629009","270984","592376","812144","1173515","2033529","2036875","100046","96700"
2017-07-18,"2140060","652015","255556","589676","803854","1202174","2045545","2047406","94515","92654"
2017-07-25,"2149971","659050","235712","631536","764804","1186870","2055390","2054118","94581","95853"
2017-08-01,"2219691","717912","231147","683826","732709","1217844","2134447","2132817","85244","86874"
2017-08-08,"2215548","707536","226907","699211","714874","1191616","2121621","2117734","93927","97814"
2017-08-15,"2311603","699351","235878","731181","781560","1255059","2212092","2222118","99511","89485"
2017-08-22,"2236977","676829","231381","713993","751249","1207115","2142071","2152489","94906","84488"
2017-08-29,"2247058","663313","297448","696444","788228","1169408","2147985","2163300","99073","83758"
2017-09-05,"2326586","675605","293492","737375","815931","1204660","2228911","2235527","97675","91059"
2017-09-12,"2345125","662650","288170","736674","857037","1236352","2256361","2261196","88764","83929"
2017-09-19,"2377488","678156","260082","752501","858264","1278201","2288921","2290784","88567","86704"
2017-09-26,"2411223","698180","244072","787828","824910","1284235","2310918","2316135","100305","95088"
2017-10-03,"2471226","687611","243295","834326","848375","1300591","2370312","2378212","100914","93014"
2017-10-10,"2437479","685322","268261","826726","822776","1242946","2334824","2337933","102655","99546"
2017-10-17,"2440472","701946","272421","834455","802074","1233592","2338475","2340468","101997","100004"
2017-10-24,"2371940","710682","263855","787873","772710","1222299","2271265","2274027","100675","97913"
2017-10-31,"2509878","734763","231814","860814","809563","1312437","2405140","2405065","104738","104813"
2017-11-07,"2601977","758743","213537","898439","836669","1388076","2493851","2500052","108126","101925"
2017-11-14,"2627570","778738","182272","945010","793419","1407503","2517167","2534785","110403","92785"
2017-11-21,"2512147","742158","165080","919287","748100","1331898","2409545","2416265","102602","95882"
2017-11-28,"2489012","763786","153953","882445","738304","1360100","2384535","2396498","104477","92514"
2017-12-05,"2554224","759978","148850","904376","787163","1410423","2451517","2463649","102707","90575"
2017-12-12,"2571686","761121","146624","925839","781944","1411274","2468904","2483737","102782","87949"
2017-12-19,"2456059","749848","148009","859583","752045","1372036","2361476","2379628","94583","76431"
2017-12-26,"2460193","772893","140732","835457","750189","1394458","2358539","2370647","101654","89546"
2018-01-02,"2479798","762666","138453","842580","766347","1414461","2371593","2395494","108205","84304"
2018-01-09,"2545313","801494","143904","863044","766612","1440710","2431150","2447658","114163","97655"
2018-01-16,"2611581","854090","146303","886720","755208","1486922","2496018","2519945","115563","91636"
2018-01-23,"2593128","852332","135637","889772","737640","1476614","2479744","2502023","113384","91105"
2018-01-30,"2643683","866033","131475","936977","727045","1491842","2530055","2560294","113628","83389"
2018-02-06,"2589270","862102","123005","891857","724228","1485652","2478187","2500514","111083","88756"
2018-02-13,"2530604","837456","125195","889842","691555","1427468","2418853","2442505","111751","88099"
2018-02-20,"2431805","804138","114772","860794","666886","1382974","2331818","2358540","99987","73265"
2018-02-27,"2460214","823435","119331","864531","670505","1400494","2358471","2384356","101743","75858"
2018-03-06,"2451492","814991","128484","836342","694814","1409362","2346147","2374188","105345","77304"
2018-03-13,"2403162","799257","130724","766827","729556","1426920","2295640","2324471","107522","78691"
2018-03-20,"2392391","823181","119473","747842","711442","1435318","2282465","2302633","109926","89758"
2018-03-27,"2513575","854255","138485","792827","748843","1486874","2395925","2418186","117650","95389"
2018-04-03,"2547337","829287","129742","822688","784653","1509217","2436628","2461647","110709","85690"
2018-04-10,"2480033","836353","129273","799276","736394","1464070","2372023","2392619","108010","87414"
2018-04-17,"2596578","849993","121862","877662","762457","1506450","2490112","2505974","106466","90604"
2018-04-24,"2574820","838898","126475","865684","760726","1499069","2465308","2491228","109512","83592"
2018-05-01,"2621768","815176","124449","879091","814396","1534302","2508663","2537842","113105","83926"
2018-05-08,"2658229","804806","124878","886152","856480","1554820","2547438","2565850","110791","92379"
2018-05-15,"2706454","772511","128067","933001","882946","1557321","2588458","2618389","117996","88065"
2018-05-22,"2643354","750320","116934","925459","843227","1508729","2519006","2551122","124348","92232"
2018-05-29,"2620926","729699","121871","925732","835222","1487851","2490653","2535454","130273","85472"
2018-06-05,"2546827","709364","125788","880575","829414","1462700","2419353","2469063","127474","77764"
2018-06-12,"2524439","720342","125049","858594","819735","1460483","2398671","2444126","125768","80313"
2018-06-19,"2458404","694421","113474","860297","789790","1409863","2344508","2383634","113896","74770"
2018-06-26,"2423829","719301","94210","830062","759679","1415137","2309042","2339409","114787","84420"
2018-07-03,"2466531","762738","106018","851294","741490","1425416","2355522","2382728","111009","83803"
2018-07-10,"2499172","755271","100806","871904","759616","1446697","2386791","2419407","112381","79765"
2018-07-17,"2440486","710471","79177","865902","754424","1425647","2330797","2370726","109689","69760"
2018-07-24,"2361062","688176","77705","832249","734311","1385967","2254736","2295921","106326","65141"
2018-07-31,"2349169","698719","85319","818969","729197","1380794","2246885","2285082","102284","64087"
2018-08-07,"2342575","691708","82781","813759","726683","1379031","2232150","2275571","110425","67004"
2018-08-14,"2329989","655245","81817","837055","728661","1347408","2220961","2266280","109028","63709"
2018-08-21,"2235767","642062","103277","792767","702718","1281562","2137547","2177606","98220","58161"
2018-08-28,"2240977","654384","104071","780443","707358","1293184","2142185","2177698","98792","63279"
2018-09-04,"2303047","673427","107697","803168","723130","1322657","2199725","2233522","103322","69525"
2018-09-11,"2281869","652935","109090","805304","723473","1299282","2181712","2213676","100157","68193"
2018-09-18,"2228937","626914","96548","762698","740953","1308891","2130565","2168137","98372","60800"
2018-09-25,"2228937","626914","96548","762698","740953","1308891","2130565","2168137","98372","60800"
2018-10-02,"2245589","653899","104990","780257","703730","1287359","2137886","2172606","107703","72983"
2018-10-09,"2217171","633117","105066","781443","695108","1263764","2109668","2150273","107503","66898"
2018-10-16,"2218887","614423","121194","774790","725465","1262652","2114678","2158636","104209","60251"
2018-10-23,"2131494","585412","130134","729979","712772","1215587","2028163","2075700","103331","55794"
2018-10-30,"2093055","565671","133033","685554","746497","1213568","1997722","2032155","95333","60900"
2018-11-06,"2075239","554562","150779","643059","771639","1218250","1969260","2012088","105979","63151"
2018-11-13,"2110793","561445","180247","634307","810757","1230284","2006509","2044838","104284","65955"
2018-11-20,"1998866","528849","161662","605748","769964","1166354","1904561","1933764","94305","65102"
2018-11-27,"2020092","511679","163558","622743","794261","1167476","1928683","1953777","91409","66315"
2018-12-04,"2048735","505292","175146","638047","814526","1163050","1957865","1976243","90870","72492"
2018-12-11,"2050634","504584","195078","651302","801203","1132155","1957089","1978535","93545","72099"
2018-12-18,"2063376","502715","193107","643698","820153","1154438","1966566","1991243","96810","72133"
2018-12-24,"2073992","502719","196407","667631","812412","1134409","1982762","1998447","91230","75545"
2018-12-31,"2104675","502972","204259","708348","806681","1116212","2018001","2028819","86674","75856"
2019-01-08,"2120930","498716","221505","715007","820328","1095603","2034051","2032115","86879","88815"
2019-01-15,"2103777","498357","191432","710485","811898","1121322","2020740","2023239","83037","80538"
2019-01-22,"2048817","500895","166036","666563","804057","1139050","1971515","1971649","77302","77168"
2019-01-29,"2042018","499297","158386","664758","804921","1147776","1968976","1970920","73042","71098"
2019-02-05,"2057061","491870","170261","667659","816098","1148220","1975627","1986140","81434","70921"
2019-02-12,"2077398","472181","183967","684361","841465","1140393","1998007","2008721","79391","68677"
2019-02-19,"2019218","479000","165033","652748","809084","1131507","1940832","1949288","78386","69930"
2019-02-26,"2025884","486235","158564","638084","822211","1159831","1946530","1956479","79354","69405"
2019-03-05,"2067851","497656","148855","677350","811089","1168664","1986095","1994869","81756","72982"
2019-03-12,"2012864","500169","137904","676159","753879","1123382","1930207","1937445","82657","75419"
2019-03-19,"1962559","534563","119817","646466","701175","1128022","1882204","1894305","80355","68254"
2019-03-26,"1968511","560552","111933","631916","696940","1152358","1889408","1896207","79103","72304"
2019-04-02,"1975009","590312","108951","593203","702767","1190040","1886282","1892194","88727","82815"
2019-04-09,"2021814","621766","105104","590879","712040","1247522","1924685","1943505","97129","78309"
2019-04-16,"2092151","616110","100852","651367","732726","1262716","2000203","2014935","91948","77216"
2019-04-23,"2139213","644670","97311","681173","716970","1287439","2042813","2065923","96400","73290"
2019-04-30,"2144648","638298","114195","704217","711575","1260738","2054090","2079150","90558","65498"
2019-05-07,"2133539","616789","122453","725965","693384","1214963","2036138","2063381","97401","70158"
2019-05-14,"2153657","607979","120171","719619","735104","1243983","2062702","2083773","90955","69884"
2019-05-21,"2085029","585979","107581","717336","690552","1192438","1993867","2017355","91162","67674"
2019-05-28,"2102854","564433","125495","732148","726384","1175461","2022965","2033104","79889","69750"
2019-06-04,"2078407","538947","138779","719965","737144","1148692","1996056","2007436","82351","70971"
2019-06-11,"2057046","515457","163802","711336","748569","1107188","1975362","1982326","81684","74720"
2019-06-18,"2003618","502749","139662","690579","731622","1094291","1924950","1924532","78668","79086"
2019-06-25,"2004961","496941","118138","690737","741191","1116099","1928869","1924974","76092","79987"
2019-07-02,"2031169","513180","120370","702476","731964","1130195","1947620","1953041","83549","78128"
2019-07-09,"1999766","505696","115547","704305","709961","1102928","1919962","1922780","79804","76986"
2019-07-16,"2089629","545484","121722","741056","718705","1150251","2005245","2013029","84384","76600"
2019-07-23,"2056492","537940","140089","730587","710726","1108214","1979253","1978890","77239","77602"
2019-07-30,"2069072","540238","152947","717612","732821","1119888","1990671","1990447","78401","78625"
2019-08-06,"2070210","540924","165283","692333","760794","1134883","1994051","1992499","76159","77711"
2019-08-13,"2059135","547040","164896","724472","715157","1086691","1986669","1976059","72466","83076"
2019-08-20,"2002847","528969","114334","713123","692171","1097984","1934263","1925441","68584","77406"
2019-08-27,"2003007","513465","121815","704731","713511","1095956","1931707","1922502","71300","80505"
2019-09-03,"2082415","508940","124783","748152","748832","1130951","2005924","2003886","76491","78529"
2019-09-10,"2080994","527579","99374","757125","716210","1140398","2000914","1996897","80080","84097"
2019-09-17,"2073041","530357","103252","723275","726980","1167263","1980612","1993790","92429","79251"
2019-09-24,"2048088","528493","104331","696030","740041","1180295","1964564","1980656","83524","67432"
2019-10-01,"2085676","514829","125510","703776","783419","1185396","2002024","2014682","83652","70994"
2019-10-08,"2105717","520283","165198","704400","793152","1156661","2017835","2026259","87882","79458"
2019-10-15,"2136717","536406","179522","732588","785449","1149906","2054443","2062016","82274","74701"
2019-10-22,"2081290","548951","182779","695827","761207","1128177","2005985","2006783","75305","74507"
2019-10-29,"2045914","552242","168895","669440","746098","1130275","1967780","1968610","78134","77304"
2019-11-05,"2083893","565026","158886","696857","738893","1144839","2000776","2000582","83117","83311"
2019-11-12,"2151499","539082","114485","763662","771412","1196163","2074156","2074310","77343","77189"
2019-11-19,"2123596","541420","111445","755070","739984","1181128","2036474","2047643","87122","75953"
2019-11-26,"2187168","553737","82801","800640","750667","1225443","2105044","2108884","82124","78284"
2019-12-03,"2163757","531120","103085","779771","769453","1207163","2080344","2090019","83413","73738"
2019-12-10,"2229813","577216","81677","790720","773624","1275613","2141560","2148010","88253","81803"
2019-12-17,"2166584","612113","75736","734859","731664","1273627","2078636","2084222","87948","82362"
2019-12-30,"2114661","625302","75225","719520","686308","1245177","2031130","2039922","83531","74739"
2019-12-31,"2145567","626848","71991","726110","708342","1275977","2061300","2074078","84267","71489"
2020-01-07,"2244930","639009","71737","776931","730106","1328031","2146046","2176699","98884","68231"
2020-01-14,"2215893","610444","80132","825954","687440","1251772","2123838","2157858","92055","58035"
2020-01-21,"2146832","599228","78660","805269","659991","1209467","2064488","2093396","82344","53436"
2020-01-28,"2172019","588255","126493","820583","677261","1163396","2086099","2110472","85920","61547"
2020-02-04,"2271741","576917","179543","817837","784991","1210117","2179745","2207497","91996","64244"
2020-02-11,"2213522","577155","180386","766575","777032","1189639","2120762","2136600","92760","76922"
2020-02-18,"2138168","571252","159488","744704","735730","1155940","2051686","2060132","86482","78036"
2020-02-25,"2179833","558798","127332","754121","779654","1219457","2092573","2100910","87260","78923"
2020-03-03,"2196089","563904","175535","737704","812983","1203153","2114591","2116392","81498","79697"
2020-03-10,"2220972","587567","200170","732828","813833","1210215","2134228","2143213","86744","77759"
2020-03-17,"2154450","572819","132582","671758","823071","1279669","2067648","2084009","86802","70441"
2020-03-24,"2141284","578366","142353","659260","804091","1270984","2041717","2072597","99567","68687"
2020-03-31,"2340672","624397","189289","715602","886042","1365436","2226041","2270327","114631","70345"
2020-04-07,"2342227","655771","170876","682318","885811","1410858","2223900","2264052","118327","78175"
2020-04-14,"2353955","700474","189805","701565","822782","1377611","2224821","2268981","129134","84974"
2020-04-21,"2276638","736248","149068","655787","783684","1376266","2175719","2181121","100919","95517"
2020-04-28,"2261202","737778","148390","641716","779516","1369801","2159010","2159907","102192","101295"
2020-05-05,"2243871","722912","192300","595388","829802","1366700","2148102","2154388","95769","89483"
2020-05-12,"2248020","709557","168538","609175","826291","1384262","2145023","2161975","102997","86045"
2020-05-19,"2158749","692017","148414","614823","748156","1323111","2054996","2086348","103753","72401"
2020-05-26,"2135678","701234","158660","607263","725955","1297095","2034452","2063018","101226","72660"
2020-06-02,"2127664","729172","160842","582846","712466","1312480","2024484","2056168","103180","71496"
2020-06-09,"2126629","732934","165025","580945","708053","1316616","2021932","2062586","104697","64043"
2020-06-16,"2076990","706483","160211","592534","681426","1261735","1980443","2014480","96547","62510"
2020-06-23,"2003477","711257","150374","551985","647160","1243038","1910402","1945397","93075","58080"
2020-06-30,"2008618","704393","160567","574399","638159","1208544","1916951","1943510","91667","65108"
2020-07-07,"1972049","686543","151226","563553","630952","1193278","1881048","1908057","91001","63992"
2020-07-14,"2019705","692258","152507","577852","662645","1223438","1932755","1953797","86950","65908"
2020-07-21,"1956768","687910","139034","565665","613323","1191979","1866898","1896678","89870","60090"
2020-07-28,"1992556","676822","144253","585027","639196","1203653","1901045","1932933","91511","59623"
2020-08-04,"2032921","693752","157486","622699","626120","1193181","1942571","1973366","90350","59555"
2020-08-11,"2060880","682827","161892","630948","652925","1209722","1966700","2002562","94180","58318"
2020-08-18,"2044952","665585","154890","634725","653925","1201672","1954235","1991287","90717","53665"
2020-08-25,"2052448","671889","171190","652017","639675","1176644","1963581","1999851","88867","52597"
2020-09-01,"2064137","665460","174545","676874","632603","1159839","1974937","2011258","89200","52879"
2020-09-08,"2046660","637225","187859","680624","636687","1116869","1954536","1985352","92124","61308"
2020-09-15,"2108987","649093","199349","694414","674641","1149488","2018148","2043251","90839","65736"
2020-09-22,"2028620","647934","175165","674853","625246","1117945","1948033","1967963","80587","60657"
2020-09-29,"2078331","648622","186711","699699","646882","1128084","1995203","2014494","83128","63837"
2020-10-06,"2111762","657787","186251","700625","670668","1159032","2029080","2045908","82682","65854"
2020-10-13,"2059382","649933","177136","675368","646900","1143815","1972201","1996319","87181","63063"
2020-10-20,"2008815","664697","174349","647834","613378","1124495","1925909","1946678","82906","62137"
2020-10-27,"2011744","659778","187688","652289","613337","1112141","1925404","1952118","86340","59626"
2020-11-03,"2013491","639145","196685","654279","632058","1099616","1925482","1950580","88009","62911"
2020-11-10,"2053450","633743","170205","680889","650044","1135537","1964676","1986631","88774","66819"
2020-11-17,"2083804","638245","157434","700087","660992","1165028","1999324","2022549","84480","61255"
2020-11-24,"2083018","673157","150518","685365","631574","1187360","1990096","2023243","92922","59775"
2020-12-01,"2122605","677347","160182","702274","646931","1206926","2026552","2069382","96053","53223"
2020-12-08,"2131913","671096","156467","704857","656757","1213232","2032710","2074556","99203","57357"
2020-12-15,"2154618","664557","150753","702543","689753","1241691","2056853","2094987","97765","59631"
2020-12-21,"2120797","665598","139896","709257","646989","1217566","2021844","2066719","98953","54078"
2020-12-29,"2121502","655694","143963","713816","658049","1209999","2027559","2067778","93943","53724"
2021-01-05,"2169541","684132","165483","718123","666425","1228276","2068680","2111882","100861","57659"
2021-01-12,"2234696","692315","164598","748159","691724","1268648","2132198","2181405","102498","53291"
2021-01-19,"2217037","664833","156249","758782","691131","1248832","2114746","2163863","102291","53174"
2021-01-26,"2316660","676393","171781","820933","718598","1269649","2215924","2262363","100736","54297"
2021-02-02,"2389677","675461","176287","834430","775736","1323943","2285627","2334660","104050","55017"
2021-02-09,"2446808","694842","180584","843054","796806","1367838","2334702","2391476","112106","55332"
2021-02-16,"2507620","697095","182382","854937","844358","1419142","2396390","2456461","111230","51159"
2021-02-23,"2460204","682881","171041","842996","829624","1399448","2355501","2413485","104703","46719"
2021-03-02,"2491831","688229","169210","882185","813268","1391104","2383682","2442499","108149","49332"
2021-03-09,"2494636","692508","155070","877238","811737","1406368","2381483","2438676","113153","55960"
2021-03-16,"2523179","680508","155066","908443","825944","1405144","2414895","2468653","108284","54526"
2021-03-23,"2321767","683015","159960","757020","775046","1352802","2215081","2269782","106686","51985"
2021-03-30,"2327016","671158","139848","792496","762929","1342122","2226583","2274466","100433","52550"
2021-04-06,"2340357","649237","137512","804197","784153","1347627","2237587","2289336","102770","51021"
2021-04-13,"2301831","643807","151129","745868","805801","1350489","2195476","2247486","106355","54345"
2021-04-20,"2346793","650867","150884","766999","826122","1374996","2243988","2292879","102805","53914"
2021-04-27,"2353470","650300","160589","762977","835304","1377445","2248581","2301011","104889","52459"
2021-05-04,"2419641","658677","158664","809772","838839","1395309","2307288","2363745","112353","55896"
2021-05-11,"2444466","650118","153557","824742","859810","1416661","2334670","2394960","109796","49506"
2021-05-18,"2458804","612530","136583","852873","891029","1423558","2356432","2413014","102372","45790"
2021-05-25,"2426045","625568","150078","851933","847843","1372383","2325344","2374394","100701","51651"
2021-06-01,"2507073","638635","147338","884087","874518","1421110","2397240","2452535","109833","54538"
2021-06-08,"2511533","657352","146853","874654","862588","1423541","2394594","2445048","116939","66485"
2021-06-15,"2474859","664365","140409","832092","868390","1440290","2364847","2412791","110012","62068"
2021-06-22,"2348317","669980","143819","815854","759883","1334321","2245717","2293994","102600","54323"
2021-06-29,"2369631","664867","142377","813830","785783","1361867","2264480","2318074","105151","51557"
2021-07-06,"2413946","640068","142717","840034","822892","1374254","2302994","2357005","110952","56941"
2021-07-13,"2413536","636318","137222","848462","819975","1367530","2304755","2353214","108781","60322"
2021-07-20,"2243475","593046","144306","799969","747511","1248047","2140526","2192322","102949","51153"
2021-07-27,"2326985","601411","151647","806813","827518","1315407","2235742","2273867","91243","53118"
2021-08-03,"2313202","583470","152943","817212","818264","1292622","2218946","2262777","94256","50425"
2021-08-10,"2194794","556062","155649","794948","747515","1194034","2098525","2144631","96269","50163"
2021-08-17,"2135698","538862","134539","793460","712347","1159601","2044669","2087600","91029","48098"
2021-08-24,"2042879","528784","154472","742224","686132","1094154","1957140","1990850","85739","52029"
2021-08-31,"2074185","515630","159102","749260","720006","1114319","1984896","2022681","89289","51504"
2021-09-07,"2107706","506565","157407","752351","756271","1147522","2015187","2057280","92519","50426"
2021-09-14,"2145165","512626","157562","760045","778938","1176126","2051609","2093733","93556","51432"
2021-09-21,"2101558","506363","150385","775813","728666","1124846","2010842","2051044","90716","50514"
2021-09-28,"2175199","527523","153709","809238","738761","1157641","2075522","2120588","99677","54611"
2021-10-05,"2230794","548561","150254","852163","726829","1170088","2127553","2172505","103241","58289"
2021-10-12,"2231227","564001","159225","840336","721614","1175298","2125951","2174859","105276","56368"
2021-10-19,"2205089","565720","136126","842754","698992","1172173","2107466","2151053","97623","54036"
2021-10-26,"2144359","550171","126453","798638","694591","1167003","2043400","2092094","100959","52265"
2021-11-02,"2121461","548631","129338","773287","705007","1166523","2026925","2069148","94536","52313"
2021-11-09,"2081385","552579","131267","727765","705286","1167250","1985630","2026282","95755","55103"
2021-11-16,"2057633","510169","94384","732676","711066","1181390","1953911","2008450","103722","49183"
2021-11-23,"2028573","510586","102929","707385","713989","1168954","1931960","1979268","96613","49305"
2021-11-30,"2033286","511862","124628","696876","710000","1142885","1918738","1964389","114548","68897"
2021-12-07,"1972536","492585","125353","672745","724626","1125057","1889956","1923155","82580","49381"
2021-12-14,"1953397","483233","136096","642987","739745","1125272","1865965","1904355","87432","49042"
2021-12-21,"1892701","478276","138021","591175","740195","1116011","1809646","1845207","83055","47494"
2021-12-28,"1867339","469946","131517","600291","711711","1084803","1781948","1816611","85391","50728"
2022-01-04,"1887131","462594","129769","617879","718728","1088684","1799201","1836332","87930","50799"
2022-01-11,"1966615","484370","123865","664595","726296","1123236","1875261","1911696","91354","54919"
2022-01-18,"2059564","503178","117397","693872","759825","1186877","1956875","1998146","102689","61418"
2022-01-25,"2095994","492310","118895","755613","749821","1170467","1997744","2044975","98250","51019"
2022-02-01,"2093735","487606","118702","787180","719202","1133860","1993988","2039742","99747","53993"
2022-02-08,"2170681","480560","117177","822041","762286","1174430","2064887","2113648","105794","57033"
2022-02-15,"2122758","458819","110726","793865","767338","1159338","2020022","2063929","102736","58829"
2022-02-22,"2058132","442102","103061","771930","743113","1126004","1957145","2000995","100987","57137"
2022-03-01,"2028476","465365","96702","733958","729585","1140540","1928908","1971200","99568","57276"
2022-03-08,"1896974","455339","93674","645419","696449","1105258","1797207","1844351","99767","52623"
2022-03-15,"1850794","444601","102786","621953","700410","1083012","1766964","1807751","83830","43043"
2022-03-22,"1788211","436560","96591","614836","654309","1034389","1705705","1745816","82506","42395"
2022-03-29,"1795929","420097","101366","635100","654965","1015127","1710162","1751593","85767","44336"
2022-04-05,"1823366","413132","104538","636642","681802","1037237","1731576","1778417","91790","44949"
2022-04-12,"1783725","411978","107200","589299","688852","1039455","1690129","1735954","93596","47771"
2022-04-19,"1740300","411622","103925","575200","661788","1013040","1648610","1692165","91690","48135"
2022-04-26,"1733586","413638","97575","597819","635548","993869","1647005","1689263","86581","44323"
2022-05-03,"1751564","419692","97991","621174","620327","986540","1661193","1705705","90371","45859"
2022-05-10,"1736594","415170","104367","616019","614716","969195","1645905","1689581","90689","47013"
2022-05-17,"1730665","416190","90553","614805","611264","975133","1642259","1680491","88406","50174"
2022-05-24,"1711863","422541","87780","618735","584496","959123","1625772","1665638","86091","46225"
2022-05-31,"1787928","421683","88707","654178","622867","996628","1698728","1739513","89200","48415"
2022-06-07,"1790618","423882","95626","651915","622320","991353","1698117","1738894","92501","51724"
2022-06-14,"1715674","409427","106481","610827","604944","946598","1625198","1663906","90476","51768"
2022-06-21,"1658636","388496","98994","588612","594860","918775","1571968","1606381","86668","52255"
2022-06-28,"1651566","396046","96354","574683","599957","927895","1570686","1598932","80880","52634"
2022-07-05,"1637862","394943","114420","559365","601996","906213","1556304","1579998","81558","57864"
2022-07-12,"1612803","375155","106827","564687","590438","884964","1530280","1556478","82523","56325"
2022-07-19,"1577616","374677","103586","549127","580330","874019","1504134","1526732","73482","50884"
2022-07-26,"1597451","368453","109193","554071","595032","878521","1517556","1541785","79895","55666"
2022-08-02,"1606910","361810","108058","554003","616741","889607","1532554","1551668","74356","55242"
2022-08-09,"1570131","338172","127521","517984","636980","875053","1493136","1520558","76995","49573"
2022-08-16,"1557349","346865","131925","492798","638971","878262","1478634","1502985","78715","54364"
2022-08-23,"1503506","341918","95698","492849","595411","863667","1430178","1452214","73328","51292"
2022-08-30,"1470207","332415","103226","471831","588601","844849","1392847","1419906","77360","50301"
2022-09-06,"1480320","326007","111529","475682","599689","840106","1401378","1427317","78942","53003"
2022-09-13,"1498059","340716","113659","480935","600618","844625","1422269","1439219","75790","58840"
2022-09-20,"1481545","342588","102710","476269","589445","851013","1408302","1429992","73243","51553"
2022-09-27,"1504991","333933","107853","497576","598428","845300","1429937","1450729","75054","54262"
2022-10-04,"1495538","331695","89696","504842","587375","848229","1423912","1442767","71626","52771"
2022-10-11,"1499498","345258","86038","493272","584609","868235","1423139","1447545","76359","51953"
2022-10-18,"1454431","336209","84664","476923","568559","842316","1381691","1403903","72740","50528"
2022-10-25,"1436942","335340","86261","465545","566297","834323","1367182","1386129","69760","50813"
